,1,1,1,1,1,1,1,1,1,1,1,1,1,1,1,1,1,1,1,1,1,1,1,1,1,1,1,1,1,1,1,
,1,3,0,0,0,0,0,0,1,0,0,0,1,0,0,0,0,6,0,0,0,0,0,0,7,0,0,0,0,0,1,
,1,0,1,1,1,1,1,0,1,0,1,0,1,1,1,0,1,1,1,1,1,1,1,1,1,1,1,1,1,0,1,
,1,0,1,0,0,0,1,0,0,0,1,0,7,0,1,0,0,0,1,0,0,0,6,0,0,0,9,0,0,0,1,
,1,1,1,0,1,1,1,1,1,1,1,1,1,0,1,1,1,0,1,0,1,1,1,1,1,1,1,1,1,0,1,
,1,0,6,0,0,0,0,0,1,0,0,0,1,0,1,0,0,0,1,0,1,0,0,0,0,0,0,0,1,0,1,
,1,0,1,1,1,0,1,1,1,0,1,0,1,7,1,1,1,0,1,0,1,1,1,1,1,1,1,0,1,7,1,
,1,0,0,0,1,0,9,0,0,0,1,0,1,0,0,0,1,0,1,0,0,0,1,0,0,0,0,0,1,0,1,
,1,1,1,0,1,1,1,1,1,1,1,0,1,1,1,0,1,1,1,1,1,0,1,0,1,1,1,1,1,0,1,
,1,0,1,0,1,0,1,0,0,0,0,0,1,0,1,0,0,0,0,7,0,0,1,0,1,0,0,0,0,0,1,
,1,0,1,0,1,6,1,0,1,1,1,0,1,0,1,1,1,1,1,1,1,1,1,0,1,0,1,1,1,1,1,
,1,0,0,0,1,0,1,0,1,0,0,0,0,0,0,0,1,0,0,0,0,0,0,7,0,0,1,0,0,0,1,
,1,0,1,1,1,0,1,0,1,1,1,1,1,1,1,1,1,0,1,1,1,1,1,1,1,1,1,1,1,0,1,
,1,0,0,9,0,0,1,0,0,9,0,0,6,0,0,0,1,0,0,0,1,0,0,0,0,0,7,0,0,0,1,
,1,1,1,1,1,0,1,1,1,1,1,1,1,1,1,8,1,1,1,0,1,1,1,0,1,1,1,1,1,1,1,
,1,0,0,0,1,0,1,0,0,0,0,0,1,0,0,6,0,0,1,0,0,0,1,0,0,0,1,0,0,0,1,
,1,0,1,0,1,0,1,0,1,1,1,1,1,0,1,1,1,1,1,1,1,0,1,0,1,0,1,0,1,0,1,
,1,0,1,0,1,0,1,0,1,0,0,0,1,0,1,0,0,0,0,9,0,0,1,0,1,0,0,0,1,0,1,
,1,0,1,1,1,0,1,0,1,0,1,0,1,7,1,0,1,1,1,1,1,1,1,0,1,1,1,1,1,0,1,
,1,7,0,0,1,0,1,0,1,0,1,0,0,0,1,0,0,0,1,0,0,0,0,0,1,0,0,0,0,0,1,
,1,0,1,0,1,0,1,0,1,0,1,1,1,1,1,1,1,0,1,0,1,1,1,1,1,0,1,1,1,0,1,
,1,0,1,0,0,0,1,7,1,0,1,0,0,0,1,0,0,0,1,0,1,0,0,0,1,0,0,0,1,0,1,
,1,0,1,1,1,1,1,0,1,0,1,0,1,0,1,0,1,1,1,1,1,0,1,0,1,0,1,0,1,0,1,
,1,0,0,0,1,0,0,0,1,0,0,0,1,0,0,0,1,0,0,0,1,0,1,0,1,0,1,0,1,0,1,
,1,1,1,0,1,1,1,0,1,1,1,1,1,1,1,1,1,0,1,0,1,0,1,0,1,1,1,0,1,1,1,
,1,0,1,0,0,0,1,0,0,0,0,6,0,9,0,0,0,0,1,0,1,0,1,0,0,0,1,0,0,0,1,
,1,0,1,1,1,0,1,1,1,1,1,0,1,1,1,1,1,1,1,0,1,0,1,1,1,0,1,1,1,0,1,
,1,0,0,0,1,0,0,0,1,0,0,0,1,0,0,0,0,0,1,7,1,0,0,0,1,0,0,7,0,0,1,
,1,0,1,1,1,1,1,0,1,0,1,1,1,0,1,1,1,1,1,0,1,1,1,0,1,1,1,1,1,0,1,
,1,0,0,0,0,0,0,9,0,0,1,0,0,0,7,0,0,6,0,0,0,0,0,0,1,2,0,6,0,0,1,
,1,1,1,1,1,1,1,1,1,1,1,1,1,1,1,1,1,1,1,1,1,1,1,1,1,1,1,1,1,1,1,5