,1,1,1,1,1,1,1,1,1,1,1,1,1,1,1,1,1,1,1,1,1,1,1,1,1,1,1,1,1,1,1,
,1,3,0,0,0,0,1,0,0,0,0,0,1,0,0,0,1,0,1,0,0,0,1,0,0,0,1,0,0,0,1,
,1,0,1,0,1,0,1,0,1,0,1,0,1,0,1,0,1,0,1,0,1,0,1,0,1,7,1,0,1,0,1,
,1,0,0,0,1,0,1,0,1,7,1,0,0,0,1,7,1,0,6,0,1,0,6,0,1,0,0,0,1,0,1,
,1,1,1,1,1,0,1,1,1,0,1,1,1,1,1,0,1,1,1,0,1,1,1,1,1,1,1,1,1,0,1,
,1,0,0,0,1,0,0,0,1,0,0,7,0,0,1,0,0,0,1,0,0,0,1,0,0,0,1,0,0,0,1,
,1,0,1,1,1,1,1,0,1,1,1,0,1,0,1,1,1,0,1,1,1,0,1,1,1,0,1,0,1,0,1,
,1,0,1,0,0,0,1,0,0,0,1,0,1,0,1,0,1,0,1,0,1,0,0,0,0,0,1,0,1,9,1,
,1,0,1,0,1,0,1,1,1,0,1,1,1,0,1,0,1,0,1,0,1,1,1,1,1,0,1,0,1,0,1,
,1,0,1,0,1,0,0,0,1,0,6,0,0,0,1,0,1,0,1,0,0,0,1,0,0,0,1,0,1,0,1,
,1,0,1,0,1,1,1,0,1,1,1,1,1,1,1,0,1,0,1,0,1,0,1,0,1,1,1,0,1,1,1,
,1,0,0,0,1,0,0,0,9,0,6,0,1,0,0,0,1,0,1,0,1,0,0,9,0,0,1,0,0,0,1,
,1,1,1,1,1,0,1,1,1,1,1,0,1,0,1,0,1,0,1,1,1,1,1,1,1,0,1,1,1,0,1,
,1,0,6,0,0,0,1,0,0,0,1,0,0,0,1,0,1,0,0,0,0,0,1,0,1,0,1,0,1,0,1,
,1,0,1,1,1,1,1,0,1,1,1,1,1,1,1,0,1,1,1,1,1,0,1,0,1,0,1,0,1,0,1,
,1,0,1,0,0,0,0,0,1,0,0,0,0,0,1,0,8,0,1,0,0,0,1,0,0,0,1,0,1,0,1,
,1,0,1,1,1,1,1,0,1,6,1,0,1,1,1,1,1,0,1,0,1,1,1,0,1,1,1,7,1,0,1,
,1,0,0,0,1,0,0,0,1,0,1,0,1,0,0,0,1,0,1,0,1,0,1,0,0,0,1,0,1,0,1,
,1,0,1,0,1,0,1,1,1,0,1,9,1,0,1,0,1,0,1,6,1,0,1,1,1,0,1,0,1,0,1,
,1,0,1,0,1,0,0,7,0,0,1,0,0,0,1,0,0,0,1,0,1,0,0,0,0,0,0,0,1,0,1,
,1,0,1,0,1,1,1,1,1,1,1,1,1,1,1,1,1,1,1,0,1,1,1,1,1,1,1,1,1,0,1,
,1,0,1,0,1,0,0,0,0,0,0,7,0,0,1,0,0,0,0,0,1,0,0,0,9,0,0,0,0,0,1,
,1,1,1,0,1,0,1,1,1,1,1,1,1,0,1,0,1,1,1,1,1,0,1,1,1,1,1,1,1,0,1,
,1,0,0,0,1,0,9,0,0,0,1,0,1,0,9,0,1,0,0,0,0,0,1,0,0,0,0,0,1,0,1,
,1,0,1,0,1,1,1,1,1,0,1,0,1,1,1,1,1,0,1,1,1,1,1,0,1,1,1,0,1,7,1,
,1,0,1,0,0,9,0,0,1,0,1,0,1,0,0,7,0,0,0,0,1,0,0,0,0,0,1,0,1,0,1,
,1,0,1,0,1,1,1,1,1,0,1,0,1,0,1,1,1,1,1,0,1,1,1,1,1,0,1,0,1,0,1,
,1,7,1,0,1,0,0,0,1,0,1,0,0,0,1,0,0,0,1,0,1,0,0,9,0,0,1,0,1,0,1,
,1,0,1,1,1,0,1,0,1,0,1,1,1,1,1,0,1,0,1,0,1,0,1,1,1,1,1,1,1,0,1,
,1,0,0,6,0,0,1,0,0,0,7,0,0,6,0,0,1,0,0,0,1,0,0,0,6,0,0,0,0,2,1,
,1,1,1,1,1,1,1,1,1,1,1,1,1,1,1,1,1,1,1,1,1,1,1,1,1,1,1,1,1,1,1,5,